####################
# #  #  #   #   # ##
# ### # # # ## #####
#   ## ## ## ### ###
### #########   ####
##  ###   ##   ### #
#   ## ## ## ### ###
### #########   ####
##  ###   ##   ### #
# #### ## ## ### ###
### #########   ####
##             ### F
#   ## ##  #   #   #
### ##### ###     ##
##  ###   #### ### #
#   #  ## ## ### ###
### #########   ####
##  ###   ##   ### #
S   #######   ######
####################