####################
S        #         #
## #### ########## #
#          #       #
#### ##### #########
#                  F
#   ## ## ## ### ###
### #########   ####
#######   ##   ### #
#   ## ## ## ### ###
### #########   ####
##  ###   ##   ### #
#   ## ## ## ### ###
### #########   ####
##  ###   ##   ### #
#   ## ## ## ### ###
### #########   ####
##  ###   ##   ### #
#   #######   ######
####################