####################
S #                #
# ################ #
#  #               #
#  #################
#   #              #
##  ############## #
#                  F
# ##################
#                  #
################## #
#                  #
# ##################
#                  #
################## #
#                  #
# ##################
#                  #
####################
####################