####################
# #  #  #   #   # ##
# ### # # # ## #####
#   ## ## ## ### ###
### #########   ####
#######   ##   ### #
S                  F
#############   ####
##  ###   ##   ### #
#   ## ## ###### ###
### #########   ####
##  ###   ##   ### #
#   ## ## ## ### ###
### #########   ####
##  ###   ##   ### #
#   ## ## ## ### ###
### #########   ####
##  ###   ##   ### #
#   #######   ######
####################