####################
S #  #  #   #   # ##
# ### # # # ## #####
#   ## ## ## ### ###
### #########   ####
##  ###   ##   ### #
#   ## ## ## ### ###
### #########   ####
##  ###        ### #
#        ###       F
### #### ####   #  #
## ####  #  #  ### #
#   ## ## ## ### ###
### #########   ####
##  ###   ##   ### #
#   ## ## ## ### ###
### #########   ####
##  ###   ##   ### #
#   #######   ######
####################