######S#############
# #  #  #   #   # ##
# ### #  # # ## ####
#   ##    ## ### ###
### ### #####   #  F
##  ###       #    #
#   ## ## ## ### ###
### #########   ####
##  ###   ##   ### #
#   ## ## ## ### ###
### #########   ####
##  ###   ##   ### #
#   ## ## ## ### ###
### #########   ####
##  ###   ##   ### #
#   ## ## ## ### ###
### #########   ####
##  ###   ##   ### #
#   #######   ######
####################