##################F#
S #  #  #   #      #
# ### # # #      ###
#   ## ## ## #######
### ####   ##   ####
##        ##   ### #
###### ## ## ### ###
### #########   ####
##  ###   ##   ### #
#   ## ## ## ### ###
### #########   ####
##  ###   ##   ### #
#   ## ## ## ### ###
### #########   ####
##  ###   ##   ### #
#   ## ## ## ### ###
### #########   ####
##  ###   ##   ### #
#   #######   ######
####################