####################
# #  #  #   #   # ##
# ### # # # ## #####
#   ## ## ## ### ###
### #########   ####
##  ###   ##   ### #
#   ## ## ## ### ###
### #########   ####
#######   ##   ### #
S   ## ## ## ### ###
### #########   ####
##        ##   ### #
# #### ## ## ### ###
### ##### ###   ####
##  ###     #      F
#   ## ## #  ### ###
### ########      ##
##  ###   #### ### #
#   #######   ######
####################