####################
# #  #  #   #   # ##
# ### # # # ## #####
#   ## ## ## ### ###
### #########   ####
##  ###   ##   ### #
#   ## ## ## ### ###
### #########   ####
##  ###   ##   ### #
#  ### ## ## ### ###
### ####       #   F
##        ##      ##
S   ## ## ## ### ###
#############   ####
##  ###   ##   ### #
#   ## ## ## ### ###
### #########   ####
##  ###   ##   ### #
#   #######   ######
####################