####################
S #  #  #   #   # ##
# ### # # # ## #####
#   ## ## ## ### ###
### #########   ####
##        ##   ### #
F   ###   ## ### ###
### #########   ####
##  ###   ##   ### #
#   ## ## ## ### ###
### #########   ####
##  ###   ##   ### #
#   ## ## ## ### ###
### #########   ####
##  ###   ##   ### #
#   ## ## ## ### ###
### #########   ####
##  ###   ##   ### #
#   #######   ######
####################