####################
S #  #  #   #   # ##
# ### # # # ## #####
#    # ## ## #     F
####   ## ###   ####
#####         ## ###
#   ## ## ## ##  ###
### ##### ###   ####
##  ###        ### #
#   ## ## ## ### ###
### #########   ####
##  ###   ##   ### #
#   ## ## ## ### ###
### #########   ####
##  ###   ##   ### #
#   ## ## ## ### ###
### #########   ####
##  ###   ##   ### #
#   #######   ######
####################