#########S##########
# #  #  #   #   # ##
# ### # # # ## #####
#   ## ## ## ### ###
### ##### ###   ####
##  ###   ##   ### #
#   ## ## ## ### ###
### ##### ###   ####
##  ###   ##   ### #
#   ## ## ## ### ###
### ##### ###   ####
##  ###   ##   ### #
#   ## ## ## ### ###
### ##### ###   ####
##  ###   ##   ### #
#   ## ## ## ### ###
### ##### ###   ####
##  ###   ##   ### #
#   ##### #   ######
#########F##########