#S################F#
# #   #  #         #
# #        ## ######
#   ## ## ## ### ###
### #########   ####
##  ###   ##   ### #
#   ## ## ## ### ###
### #########   ####
##  ###   ##   ### #
#   ## ## ## ### ###
### #########   ####
##  ###   ##   ### #
#   ## ## ## ### ###
### #########   ####
##  ###   ##   ### #
#   ## ## ## ### ###
### #########   ####
##  ###   ##   ### #
#   #######   ######
####################