#S##################
# # # #   #   #   ##
#   # # # # # # # ##
### # # # # # # # ##
# # # # # # # # # ##
### # # # # # # # ##
#   # # # # # # # ##
# ### # # # # # # ## 
# # # # # # # # # ## 
# ### # # # # # # ## 
# # # # # # # # # ## 
# # # # # # # # # ##
# # # # # # # # # ##
# # # # # # # # # ##
# ### # # # # # # ##
# # # # # # # # # ##
# # # # # # # # # ##
# # # # # # # # # ##
#   #   #   #   # ##
#F##################