####################
S #  #  #   #   # ##
# ### # # # ## #####
#   ## ## ## ### ###
### #########   ####
##        ##   ### #
#   ##    ###### ###
#######  ##      ###
##  ###      ##    F
#   ## ## ## ### ###
### #########   ####
##  ###   ##   ### #
#   ## ## ## ### ###
### #########   ####
##  ###   ##   ### #
#   ## ## ## ### ###
### #########   ####
##  ###   ##   ### #
#   #######   ######
####################